#################################
#                               #
#                               #
#       #####      #####        #
#       #              #        #
#                               #
#       #              #        #
#       #####      #####        #
#                               #
#                               #
#                               #
#################################