#####################################
#                                   #
#                                   #
#                                   #
#                                   #
#                                   #
#                                   #
#                                   #
#                                   #
#                                   #
#                                   #
#				    #
#				    #
#				    #
#####################################