#########################################################################################
#                                                                                       #
#                                                                                       #
#                               #                       #                               #
#                               #                       #                               #
#                               #                       #                               #
#                               #                       #                               #
#                               #                       #                               #
#                               #                       #                               #
#                               #                       #                               #
#                               #                       #                               #
#                               #                       #                               #
#                               #                       #                               #
#            ####################                       ####################            #
#            #                                                             #            #
#            #                                                             #            #
#                                                                                       #
#                                                                                       #
#                                                                                       #
#            #                                                             #            #
#            #                                                             #            #
#            ####################                       ####################            #
#                               #                       #                               #
#                               #                       #                               #
#                               #                       #                               #
#                               #                       #                               #
#                               #                       #                               #
#                               #                       #                               #
#                               #                       #                               #
#                               #                       #                               #
#                               #                       #                               #
#                               #                       #                               #
#                                                                                       #
#                                                                                       #
#########################################################################################