##############################
#                            #
#                            #
# ###  ###    ###  ###      #
#   #    #      #    #      #
#   #    #      #    #      #
#   #    #      #    #      #
# ###  ###    ###  ###      #
#                            #
#                            #
#                            #
##############################