##############################
#                            #
#                            #
#    ####        ####        #
#    #              #        #
#    #              #        #
#    #              #        #
#    ####        ####        #
#                            #
#                            #
#                            #
##############################