#########################################################################################################################   
#                                                                                                                       #
#                                                                                                                       #
#            ###############################################################################################            #
#            #                                                                                             #            #
#            #                                                                                             #            #
#            #                                                                                             #            #
#            #                                                                                             #            #
#            #                                                                                             #            #
#            #              ###################################                                                         #
#            #              #                                 #                                                         #
#            #              #                                 #                                                         #
#            #              #                                 #                                                         #
#            #              #                                 #                                                         #
#            #              #                                 #                                                         #
#            #              #                                 #                                                         #
#            #              #                                                                                           #
#            #              #                                                                                           #
#            #              #                                                                                           #
#            #              #                                                                                           #
#            #              #                                                                                           #
#                           ########################                                                                    #
#                                                                   ##########################                          #
#                                                                                            #              #           #
#                                                                                            #              #           #
#                                                                                            #              #           #
#                                                                                            #              #           #
#                                                                                            #              #           #
#                                                                                            #              #           #
#                                                                                            #              #           #
#                                                           #                                #              #           #
#                                                           #                                #              #           #
#                                                           #                                #              #           #
#                                                           ##################################              #           #
#                                                                                                           #           #
#            #                                                                                              #           #
#            #                                                                                              #           #
#            #                                                                                              #           #
#            #                                                                                              #           #
#            #                                                                                              #           #
#            ################################################################################################           #
#                                                                                                                       #
#                                                                                                                       #            
#########################################################################################################################