#############################################
#                                           #
#                                           #
#         #                      #          #
#         #                      #          #
#         #                      #          #
#         #                      #          #
#         #                      #          #
#         #                      #          #
#         #                      #          #
#         #                      #          #
#         #                      #          #
#         #                      #          #
#                                           #
#                                           #
#                                           #
#############################################